"","ETS_EPL24","Lower foothill","Lowland river","Mountain stream","Upper foothill","Total"
"1","LC_WP",3,1,7,3,14
"2","LC_MP",2,1,5,0,8
"3","VU_WP",1,0,0,0,1
"4","VU_MP",0,0,0,2,2
"5","LC_PP",5,1,7,9,22
"6","LC_NP",3,3,4,4,14
"7","VU_PP",0,0,0,1,1
"8","VU_NP",0,1,0,0,1
"9","EN_WP",0,1,0,0,1
"10","EN_MP",3,2,6,1,12
"11","CR_WP",0,0,1,0,1
"12","CR_MP",1,7,3,2,13
"13","EN_PP",9,4,6,10,29
"14","EN_NP",1,1,3,4,9
"15","CR_PP",18,11,10,13,52
"16","CR_NP",12,16,4,10,42
"17","Total",58,49,56,59,222
